八达岭站	北京市延庆县八达岭镇	√	　	　	
霸州站	河北省霸州市迎宾路火车站	√	√	√	
白涧站	河北省涞水县赵各庄镇	√	　	　	
百里峡站	河北省涞水县九龙镇苟各庄村	√	　	　	
宝坻站	天津市宝坻区火车站路1号	√	　	　	
保定东站	河北省保定市东风东路高铁保定东站	√	　	　	
保定站	河北省保定市新华路118号	√	　	　	
北戴河站	河北省秦皇岛市北戴河区站南大街54号	√	　	　	
北京北站	北京市西城区北滨河路1号	√	　	　	
北京东站	北京市朝阳区百子湾路27号	　	　	　	
北京南站	北京市丰台区车站路12号	√	　	　	
北京西站	北京市丰台区莲花池东路118号	√	√	√	
北京站	北京市东城区毛家湾胡同甲13号	√	√	√	
北马圈子	河北省承德市鹰手营子矿区北马圈子镇	√	　	　	
滨海北站	天津市滨海新区茶东村（滨汉公路茶淀地道口附近）	√	　	　	
滨海站	天津市滨海新区西中环快速路与华山道交叉口西侧	√	　	　	
泊头站	河北省泊头市胜利东路东端	√	√	√	
沧州西站	河北省沧州市沧县北京路西端头	√	　	　	
沧州站	河北省沧州市新华区新华东路2号	√	√	√	
昌黎站	河北省秦皇岛市昌黎县民生街南端	√	　	　	
昌平北站	北京市昌平区昌平北站	√	　	　	
昌平站	北京市昌平区马池口下念头村	√	　	　	
承德站	河北省承德市双桥区车站路235号	√	√	√	
磁山站	河北省武安市磁山镇中孔壁村	√	√	√	
磁县站	河北省磁县友谊路2号	√	　	　	
大营镇站	河北省衡水市枣强县大营镇站前街	√	　	　	
德州东站	山东省德州市经济开发区	√	　	　	
德州站	山东省德州市德城区迎宾路甲1号	√	　	　	
定州东站	河北省定州市杨家乡小渡河村	√	　	　	
定州站	河北省定州市博陵北街62号	√	√	√	
东光站	河北省沧州市东光县观州路与建设大街交口	√	√	√	
抚宁站	河北省秦皇岛市抚宁县迎宾路与102国道交叉环岛北200米铁工小区	√	　	　	
高碑店东站	河北省高碑店市方官镇庄夥村兴隆大街高碑店东站	√	　	　	
高碑店站	河北省高碑店市迎宾路1号	√	√	√	
高邑西站	河北省石家庄市高邑县站前街1号	√	　	　	
高邑站	河北省石家庄市高邑县凤中路新建大街53号	√	　	　	
藁城站	河北省石家庄藁城市迎宾大道西25号	√	　	　	
官厅站	河北省张家口市怀来县官厅镇	√	　	　	
邯郸东站	河北省邯郸市高开区高铁邯郸东站	√	　	　	
邯郸站	河北省邯郸市邯山区车站街2号	√	√	√	
衡水站	河北省衡水市桃城区中心街1号	√	√	√	
怀柔北站	北京市怀柔区怀柔北站	√	　	　	
怀柔站	北京市怀柔区府前东街1号	√	　	　	
黄村站	北京市大兴区黄村镇林校路	√	　	　	
蓟县站	天津市蓟县城关镇火车站路1号	√	　	　	
晋州站	河北省石家庄晋州市沧石路南光明街1号	√	　	　	
井店站	河北省涉县井店镇下庄	√	　	　	
井南站	河北省石家庄市井陉县天长镇	√	　	　	
井陉站	河北省石家庄市井陉县微水镇	√	　	　	
静海站	天津市静海县东方红路与联盟大街交口	√	√	√	
军粮城北站	天津市东丽区军粮城镇新安路1号	√	　	　	
康庄站	北京市延庆县康庄站	√	　	　	
涞源站	河北省涞源县涞源火车站	√	　	　	
廊坊北站	河北省廊坊市广阳区解放道55号	√	√	√	
廊坊站	河北省廊坊市安次区常甫路北端	√	　	　	
黎城站	山西省长治市黎城县广邯街2号	√	　	　	
龙华站	河北省衡水市景县龙华镇衡德路北	√	　	　	
隆化站	河北省承德市隆化县北安路8号	√	√	√	
卢龙站	河北省秦皇岛市卢龙县印庄乡政府北700米	√	　	　	
潞城站	山西省潞城市站前路1号	√	　	　	
滦河站	河北省迁安市野鸡坨镇野鸡坨村	√	　	　	
滦平站	河北省承德市滦平县振兴路西侧164号	√	　	　	
滦县站	河北省唐山市滦县新城燕山大街205国道北	√	　	　	
密云站	北京市密云县车站路1号	√	　	　	
南宫东站	河北省邢台南宫市段芦头镇	√	　	　	
南口站	北京市昌平区南口镇交通街84号	√	　	　	
南峪站	河北省石家庄市井陉县南峪镇	√	　	　	
娘子关站	山西省阳泉市平定县娘子关镇	√	　	　	
平泉站	河北省承德市平泉县东方街	√	√	√	
迁安站	河北省唐山迁安市城南油井西400米	√	　	　	
前磨头站	河北省衡水深州市前磨头镇商业街南头	√	　	　	
秦皇岛	河北省秦皇岛市海港区迎宾路北端	√	　	　	
青县站	河北省沧州市青县清州镇迎宾路72号	√	√	√	
清河站	北京市海淀区清河火车站	√	　	　	
清华园站	北京海淀区知春路大运村北航西门对面	√	　	　	
饶阳站	河北省衡水市饶阳县富强街186号	√	　	　	
任丘站	河北省任丘市渤海路1号	√	√	√	
三河县站	河北省廊坊三河市居安小区府东路南	√	　	　	
三家店站	北京市门头沟区三家店火车站	√	　	　	
沙城站	河北省张家口市怀来县沙城镇车站街1号	√	√	√	
沙河市站	河北省沙河市白云路12号	√	　	　	
沙岭子站	河北省张家口市宣化区沙岭子镇二里丰村	√	　	　	
上板城南站	河北省承德市开发新区上板城镇	√	　	　	
上板城站	河北省承德市双桥区开发新区卸甲营村	√	　	　	
涉县站	河北省邯郸市涉县迎宾街	√	√	√	
深州站	河北省衡水深州市桃源大街1号	√	　	　	
十渡站	北京市房山区十渡镇十渡村	√	　	　	
石家庄北站	河北省石家庄市新华区市庄路265号	√	　	　	
石家庄站	河北省石家庄市桥西区京广西街	√	√	√	
顺义站	北京市顺义区站前北街17号	√	　	　	
肃宁站	河北省沧州市肃宁县站前街	√	　	　	
唐山北站	河北省唐山市丰润区迎宾路1号	　	　	　	
唐山站	河北省唐山市路北区站前路160号	√	　	　	
塘沽站	天津市塘沽区大连道2543号	√	　	　	
天津南站	天津市西青区张家窝镇	√	　	　	
天津西站	天津市红桥区西站前街1号	√	　	　	
天津站	天津市河北区新纬路1号	√	√	√	
通州西站	北京市通州区五里店西路11号	√	　	　	
吴桥站	河北省吴桥县站前一路西端	√	√	√	
武安站	河北省武安市铁北路256号	√	√	√	
武清站	天津市武清区前进道上佛罗伦萨小镇对过	√	　	　	
下板城站	河北省承德县下板城镇车站路1号	√	　	　	
下花园站	河北省张家口市下花园区公路街7号	√	　	　	
下台子站	河北省承德市兴隆县李家营乡下台子站	√	　	　	
小寺沟站	河北省承德市平泉县南五十家子镇	√	　	　	
辛集站	河北省辛集市兴华路1号	√	√	√	
新杖子站	河北省承德市承德县新杖子村新达胡同1号	√	　	　	
兴隆县站	河北省承德市兴隆县雾灵街	√	　	　	
邢台东站	河北省邢台市经济开发区振兴一路邢台东站	√	　	　	
邢台站	河北省邢台市车站北路20号	√	√	√	
徐水站	河北省保定徐水县康明中路车站街12号	　	　	　	
宣化站	河北省张家口市宣化区车站街1号	√	√	√	
延庆站	北京市延庆县妫水南街59号	√	　	　	
岩会站	山西省阳泉市平定县巨城镇	√	　	　	
燕郊站	河北省廊坊三河市燕郊开发区京榆大街938号	√	　	　	
燕山站	北京市房山区燕山中路7号	√	　	　	
阳泉北站	山西省阳泉市盂县水神山路1号	√	　	　	
阳泉站	山西省阳泉市德胜街130号	√	　	　	
阳邑站	河北省武安市阳邑镇	√	　	　	
杨柳青站	天津市西青区杨柳青镇西青道	√	　	　	
野三坡站	河北省涞水县野三坡镇	√	　	　	
鹰手营子站	河北省承德市鹰手营子矿区	√	　	　	
玉田县站	河北省唐山市玉田县无终街货场路299号	√	　	　	
元氏站	河北省石家庄市元氏县站西路26号	√	　	　	
枣强站	河北省衡水市枣强县富强路中段	√	　	　	
张家口南站	河北省张家口市高新区站前西大街11号	√	√	√	
张家口站	河北省张家口市桥东区东安大街1号	　	　	　	
正定机场站	河北省石家庄市正定县新城铺镇合家庄村东正定机场站	√	　	　	
涿州东站	河北省涿州市高新产业开发区高铁新城涿州东站	√	　	　	
涿州站	河北省涿州市迎宾路73号	√	　	　	
