巴彦高勒	内蒙古自治区巴彦淖尔市磴口县	√	　	　	
白音察干	内蒙古自治区乌兰察布市察右后旗	√	　	　	
白云鄂博	内蒙古自治区包头市白云鄂博矿区火车站	√	　	　	
包头	内蒙古自治区包头市阿尔丁大街南端	√	√	√	
包头东	内蒙古包头市东河区南门外大街32号	√	　	　	
宝拉格	内蒙古自治区乌兰察布市察右后旗	√	　	　	
贲红站	内蒙古自治区乌兰察布市察右后旗贲红镇	√	　	　	
查布嘎	内蒙古自治区赤峰市阿鲁科尔沁旗天山镇查布嘎站	√	　	　	
察素齐	内蒙古自治区呼和浩特市土默特左旗察素齐镇博彦路南	√	　	　	
达拉特西站	内蒙古鄂尔多斯市达拉特旗展旦召福茂城	√	　	　	
大板	内蒙古自治区赤峰市巴林右旗大板镇林东火车站	√	　	　	
大陆号	内蒙古自治区乌兰察布市哈尔右翼后旗贲红镇大陆号	√	　	　	
东胜西	内蒙古自治区鄂尔多斯市装备基地动力大道以东	√	　	　	
额济纳	内蒙古自治区阿拉善盟额济纳旗额济纳火车站	√	　	　	
二连站	内蒙古自治区锡林郭勒盟二连浩特市迎宾北路2号	√	√	√	
丰镇	内蒙古自治区乌兰察布市	√	√	√	
公庙子	内蒙古自治区巴彦淖尔市乌拉特前旗先锋镇公庙子站	√	　	　	
呼和浩特东站	内蒙古自治区呼和浩特新城区南店呼和浩特东客站	√	√	√	
呼和浩特站	内蒙古呼和浩特市新城区车站东街41号	√	　	　	
化德站	内蒙古自治区乌兰察布市化德县	√	　	　	
集宁南	内蒙古自治区乌兰察布市集宁区怀远北大街96号	√	√	√	
经棚	内蒙古自治区赤峰市克什克腾旗经棚镇经棚火车站	√	　	　	
开鲁	内蒙古自治区通辽市开鲁县火车站	√	　	　	
林东	内蒙古自治区赤峰市巴林左旗林东镇林东火车站	√	　	　	
林西	内蒙古自治区赤峰市林西县林西镇林西火车站	√	　	　	
临河	内蒙古自治区巴彦淖尔市临河区胜利南路临河火车站	√	√	√	
旗下营	内蒙古自治区乌兰察布市卓资县	√	　	　	
萨拉齐	内蒙古自治区包头市土右旗萨拉齐镇站前街1号	√	　	　	
赛汉塔拉	内蒙古自治区锡林郭勒盟苏尼特右旗赛汉塔拉镇赛汉塔拉火车站	√	　	　	
桑根达来	内蒙古自治区锡林郭勒盟正蓝旗桑根达来镇	√	　	　	
商都站	内蒙古自治区乌兰察布市商都县红旗街	√	 	 	
土贵乌拉	内蒙古自治区乌兰察布市察右前旗土贵乌拉镇	√	　	　	
土牧尔台	内蒙古自治区乌兰察布市察右后旗	√	　	　	
乌海西站	内蒙古自治区乌海市乌达区三道坎	√	√	√	
乌海站	内蒙古自治区乌海市海勃湾区新华西街68号	√	√	√	
乌拉山	内蒙古自治区巴彦淖尔市乌拉特前旗乌拉山镇	√	　	　	
乌拉特前旗	内蒙古自治区巴彦淖尔市乌拉特前旗乌拉山镇红旗南路一街坊	√	　	　	
乌兰哈达	内蒙古自治区乌兰察布市察右后旗乌兰哈达乡	√	　	　	
五原站	内蒙古自治区巴彦淖尔市五原巴彦套海镇	√	　	　	
西小召站	内蒙古自治区巴彦淖尔市乌拉特前旗西小召镇	√	　	　	
锡林浩特	本站位于内蒙古自治区锡林浩特市	√	　	　	
兴和西	内蒙古自治区乌兰察布市兴和县城关镇	√	　	　	
哲里木	内蒙古自治区通辽市河西镇哲里木火车站	√	　	　	
正镶白旗	内蒙古自治区锡林郭勒盟正镶白旗明安图镇朝格温都尔开发区	√	　	　	
朱日和	内蒙古自治区锡林郭勒盟苏尼特右旗	√	　	　	
卓资东	内蒙古自治区乌兰察布市卓资县工业园区	√	　	　	
卓资山	内蒙古自治区乌兰察布市卓资县	√	　	　	
