阿贵图	内蒙古自治区乌兰察布市察右后旗	√	　	　	
艾不盖	内蒙古自治区包头市九原区	√	　	　	
敖日布格图	内蒙古自治区赤峰市阿鲁科尔沁旗绍根苏木敖日布格图线路所	√	　	　	
八家子	内蒙古自治区赤峰市阿鲁科尔沁旗天山口镇八家子村线路所	√	　	　	
八苏木	内蒙古自治区乌兰察布市卓资县	√	　	　	
巴彦郭勒	内蒙古自治区锡林郭勒盟苏尼特右旗	√	　	　	
坝梁	内蒙古自治区包头市固阳县西斗铺乡	√	　	　	
白彦花	内蒙古自治区巴彦淖尔市乌拉特前旗巴音花镇	√	　	　	
白彦花站	内蒙古自治区巴彦淖尔市乌拉特前旗巴音花镇	√	　	　	
白音库伦	内蒙古自治区锡林郭勒盟锡林浩特市境内	√	　	　	
白音特拉	内蒙古自治区乌兰察布市化德县境内	√	　	　	
白音乌拉	内蒙古自治区赤峰市克什克腾旗经棚镇白土井子村白音乌拉火车站	√	　	　	
白银哈尔	内蒙古自治区锡林郭勒盟苏尼特右旗	√	　	　	
白云鄂博南	内蒙古自治区包头市白云区	√	　	　	
半截店	内蒙古自治区通辽市丰田镇半截店林场半截店火车站	√	　	　	
宝木吐	内蒙古自治区赤峰市巴林右旗巴彦塔拉苏木宝木吐村宝木吐火车站	√	　	　	
保健	内蒙古自治区乌兰察布市化德县七号镇境内	√	　	　	
堡子湾	山西省大同市新荣区堡子湾镇	√	　	　	
北井子	内蒙古自治区赤峰市克什克腾旗浩来呼热乡北井子线路所	√	　	　	
贝力克	本站位于内蒙古自治区锡林浩特市贝力克牧场境内	√	　	　	
贲红站	内蒙古自治区乌兰察布市察右后旗贲红镇	√	　	　	
本井	内蒙古自治区阿拉善左旗	√	　	　	
毕克齐	内蒙古自治区呼和浩特市土默特左旗	√	　	　	
曹不罕站	内蒙古自治区乌兰察布市察右后旗贲红镇曹不罕村	√	　	　	
查干哈达	内蒙古自治区赤峰市巴林左旗查干哈达苏木查干哈达火车站	√	　	　	
查干浑地	内蒙古自治区赤峰市巴林右旗大板镇十家子嘎查查干浑地火车站	√	　	　	
查干芒和	内蒙古自治区锡林郭勒盟正蓝旗	√	　	　	
查干特格	格日勒敖都苏木陶力嘎查    	√	　	　	
朝格温多尔	内蒙古自治区锡林郭勒盟正镶白旗	√	　	　	
楚鲁图	苏尼特右旗赛汗塔拉镇格苏木	√	　	　	
达日其嘎	内蒙古自治区赤峰市巴林左旗查干哈达苏木达日其嘎嘎查火车	√	　	　	
大官银号	内蒙古自治区通辽市科尔沁区莫力庙苏木官银号村大官银号火车站	√	　	　	
道德	内蒙古自治区赤峰市阿鲁科尔沁旗绍根苏木清河子村火车站	√	　	　	
道劳毛道	内蒙古自治区赤峰市巴林左旗哈达英格乡道劳毛道村道劳毛道线路所	√	　	　	
道仑郭勒	内蒙古自治区锡林郭勒盟正镶白旗	√	　	　	
德日斯图	内蒙古自治区锡林郭勒盟苏尼特右旗	√	　	　	
东白城子	内蒙古自治区赤峰市阿鲁科尔沁旗天山口镇东白城子村东白城子线路所	√	　	　	
东胡尔清线路所	内蒙古自治区锡林郭勒盟正镶白旗	√	　	　	
东兴	内蒙古自治区包头市东河区	√	　	　	
二道沟站	内蒙古自治区乌兰察布市商都县	√	　	　	
福巨	内蒙古自治区通辽市莫力庙苏木福巨嘎查福巨火车站	√	　	　	
福山地	内蒙古自治区赤峰市巴林左旗隆昌镇福山地线路所	√	　	　	
福生庄	内蒙古自治区乌兰察布市卓资县	√	　	　	
福兴地	内蒙古自治区赤峰市阿鲁科尔沁旗天山口镇天宏村福兴地火车站	√	　	　	
嘎拉德斯汰	内蒙古自治区赤峰市克什克腾旗热水开发区嘎拉德斯汰火车站	√	　	　	
高家村	内蒙古自治区乌拉特前旗明安镇义和店村高家村组 	√	　	　	
格日苏	锡林郭勒正镶白旗城关镇北山村境内	√	　	　	
公积坂	内蒙古自治区包头市东河区	√	　	　	
公主埂	内蒙古自治区赤峰市克什克腾旗达尔罕苏木公主埂火车站	√	　	　	
姑家堡	内蒙古自治区乌兰察布市卓资县	√	　	　	
孤山	山西省大同市南郊区古店镇	√	　	　	
古尔班	内蒙古自治区锡林郭勒盟正镶白旗	√	　	　	
古鲁满汉	内蒙古自治区赤峰市巴林右旗巴彦塔拉苏木老道板嘎查古鲁满汉火车站	√	　	　	
郭尔奔敖包	苏尼特右旗赛汗塔拉镇额苏木	√	　	　	
哈达山	内蒙古自治区赤峰市克什克腾旗经棚镇新庙乡哈达山村哈达山火车站	√	　	　	
哈业胡同	内蒙古自治区包头市九原区哈业胡同乡	√	　	　	
汗苏鲁	内蒙古自治区赤峰市克什克腾旗经棚镇绍布嘎梁村汗苏鲁火车站	√	　	　	
杭锦旗	内蒙古自治区鄂尔多斯市杭锦旗	√	　	　	
好鲁库	内蒙古自治区赤峰市克什克腾旗好鲁库乡好鲁库火车站	√	　	　	
浩音呼都格	内蒙古自治区锡林郭勒盟正蓝旗赛音胡都嘎苏木浩音呼都格线路所	√	　	　	
贺日斯台	内蒙古自治区锡林郭勒盟正蓝旗贺日斯台苏木贺日斯台火车站	√	　	　	
黑沙土	内蒙古自治区阿拉善左旗	√	　	　	
红砂坝	内蒙古自治区乌兰察布市丰镇市	√	　	　	
呼尔吉音	内蒙古自治区锡林郭勒盟正蓝旗境内	√	　	　	
黄白茨	内蒙古自治区乌海市海南区	√	　	　	
灰腾梁	本站位于内蒙古自治区锡林郭勒盟阿巴嘎旗境内	√	　	　	
吉兰太	内蒙古自治区阿拉善左旗	√	　	　	
碱柜	内蒙古自治区伊克昭盟鄂克托旗	√	　	　	
金家店	内蒙古自治区通辽市开鲁县东风镇金家店火车站	√	　	　	
旧庙	内蒙古自治区赤峰市克什克腾旗好鲁库乡旧庙村旧庙火车站	√	　	　	
老羊壕	内蒙古包头市固阳县西斗铺镇	√	　	　	
六地沟	内蒙古自治区赤峰市克什克腾旗热水开发区三地村六地沟火车站	√	　	　	
芦家村	内蒙古自治区乌兰察布市察右后旗	√	　	　	
麻斯塔拉	内蒙古自治区赤峰市巴林右旗大板镇麻斯塔拉嘎查麻斯塔拉线路所	√	　	　	
马盖图	内蒙古自治区乌兰察布市卓资县	√	　	　	
马架子	内蒙古自治区赤峰市克什克腾旗经棚镇马架子村马架子火车站	√	　	　	
美岱召	内蒙古自治区包头市土默特右旗美岱召镇	√	　	　	
蒙根塔拉	内蒙古自治区赤峰市克什克腾旗经棚镇蒙根塔拉火车站	√	　	　	
庙梁	内蒙古自治区乌兰察布市兴和县额尔墩乡	√	　	　	
民族	呼和浩特市赛罕区榆林镇	√	　	　	
明安	内蒙古自治区乌拉特前旗明安镇	√	　	　	
南洼营	内蒙古自治区赤峰市克什克腾旗热水镇南洼营村南洼营线路所	√	　	　	
南园村	内蒙古自治区包头市东河区	√	　	　	
平安地	内蒙古自治区通辽市开鲁县义和塔拉镇核心村平安地火车站	√	　	　	
平顶庙	内蒙古自治区赤峰市巴林右旗大板镇平顶庙火车站	√	　	　	
七苏木	内蒙古自治区乌兰察布市白海子乡	√	　	　	
齐哈日格图	格日勒敖都苏木齐哈日格图移民区    	√	　	　	
旗下营东站	内蒙古自治区乌兰察布市卓资县	√	　	　	
萨拉齐东	内蒙古自治区包头市土右旗萨拉齐镇	√	　	　	
赛乌苏	格日勒敖都苏木赛乌苏嘎查    	√	　	　	
赛音胡都格	内蒙古自治区锡林郭勒盟正蓝旗赛音胡都嘎苏木赛音胡都格火车站	√	　	　	
三卜素	内蒙古自治区土右旗	√	　	　	
三道营	内蒙古自治区乌兰察布市卓资县	√	　	　	
三地	内蒙古自治区赤峰市克什克腾旗热水开发区三地村三地火车站	√	　	　	
三介海子站	内蒙古自治区乌兰察布市商都县	√	　	　	
三营图站	内蒙古自治区乌兰察布市商都县	√	　	　	
桑根达来北	内蒙古自治区锡林郭勒盟正蓝旗境内	√	　	　	
桑根达来东	内蒙古自治区锡林郭勒盟正蓝旗境内	√	　	　	
沙沁塔拉	内蒙古自治区赤峰市巴林右旗幸福之路苏木查干勿苏五队沙沁塔拉火车站	√	　	　	
沙日乃	内蒙古自治区赤峰市阿鲁科尔沁旗绍根苏木浩力宝嘎查沙日乃火车站	√	　	　	
上店	内蒙古自治区赤峰市克什克腾旗经棚镇新庙乡合义村上店火车站	√	　	　	
绍根	内蒙古自治区赤峰市阿鲁科尔沁旗绍根苏木绍根线路所	√	　	　	
十八台	内蒙古自治区乌兰察布市卓资县	√	　	　	
石门村	内蒙古自治区乌兰察布市集宁区怀远北大街180号	√	　	　	
四分滩	内蒙古自治区巴彦淖尔市婺源县天吉泰镇	√	　	　	
苏宏图	内蒙古自治区阿拉善盟左旗乌力吉苏木镇苏宏图车站	√	　	　	
苏集	内蒙古自治区乌兰察布市集宁区	√	　	　	
苏木特线路所	内蒙古自治区锡林郭勒盟正蓝旗	√	　	　	
陶卜齐	呼和浩特市赛罕区榆林镇	√	　	　	
陶思浩	内蒙古自治区土默特左旗陶思浩乡	√	　	　	
头道桥	内蒙古自治区巴彦淖尔市杭锦后旗黄河镇	√	　	　	
头地	内蒙古自治区赤峰市克什克腾旗经棚镇头地村头地线路所	√	　	　	
瓦窑坝	内蒙古自治区包头市九原区	√	　	　	
王福林	内蒙古自治区通辽市科尔沁区莫力庙苏木官家窑村	√	　	　	
温都和硕	内蒙古自治区赤峰市林西县大川乡温都村温都和硕火车站	√	　	　	
乌海北	内蒙古自治区乌海市海勃湾区	√	　	　	
乌兰哈达	内蒙古自治区乌兰察布市后旗县乌兰哈达乡	√	　	　	
乌兰胡同	内蒙古包头市白云鄂博包白线自包头西站起126km+47.38m处	√	　	　	
乌兰花	内蒙古自治区锡林郭勒盟苏尼特右旗	√	　	　	
乌力吉尔	内蒙古自治区赤峰市巴林左旗查干哈达苏木乌力吉尔线路所	√	　	　	
乌日图	内蒙古自治区锡林郭勒盟正蓝旗境内	√	　	　	
乌苏图查干	内蒙古自治区锡林郭勒盟正蓝旗境内	√	　	　	
西斗铺	内蒙古自治区包头市固阳县	√	　	　	
西沟	内蒙古自治区赤峰市阿鲁科尔沁旗天山镇西沟线路所	√	　	　	
西胡尔清	内蒙古自治区锡林郭勒盟正镶白旗	√	　	　	
西里	格日勒敖都苏木呼格吉乐图雅嘎查    	√	　	　	
锡林呼都嘎	苏尼特右旗赛汗塔拉镇查干呼哨苏木	√	　	　	
下坑子	内蒙古自治区赤峰市克什克腾旗经棚镇下坑子村下坑子火车站	√	　	　	
下乌苏	内蒙古自治区锡林郭勒盟正镶白旗	√	　	　	
夏拉哈马	格日勒敖都苏木陶力嘎查    	√	　	　	
小兴隆地	内蒙古自治区赤峰市阿鲁科尔沁旗先锋乡大兴隆地东沟村	√	　	　	
新安庄	内蒙古自治区乌兰察布市丰镇市	√	　	　	
兴和	内蒙古自治区乌兰察布市化德县七号镇境内	√	　	　	
星耀	锡林郭勒正镶白旗星曜乡境内	√	　	　	
牙拉盖图	内蒙古自治区锡林郭勒盟正蓝旗境内	√	　	　	
衙门庙	内蒙古自治区赤峰市巴林左旗林东镇衙门庙村衙门庙火车站	√	　	　	
营盘湾	内蒙古自治区乌兰察布市集宁区怀远北大街180号	√	　	　	
永旺	内蒙古自治区乌兰察布市化德县七号镇境内	√	　	　	
宇宙地	内蒙古自治区赤峰市克什克腾旗宇宙地乡宇宙地火车站	√	　	　	
准沙日乌苏	内蒙古自治区赤峰市阿鲁科尔沁旗绍根苏木准沙日乌苏村准沙日乌苏火车站	√	　	　	
